111111111111111111111111111111111111111111111111111111111111
10000000000000000000000000000000000000000000000000000000PEC1
111111111111111111111111111111111111111111111111111111111111