11111111111111
1E00000000C001
11111111111001
10000000000001
10000000000001
10000000000001
1000000C000001
10000011111111
10000000000001
10001111000001
10000000000001
100000CCCC0001
10011111111111
100000000000P1
11111111111111